200
50
0000000000000000000000000000000000000000000000000000000000000000000000000000000000000000000000000000000000000000000000000000000000000000000000000000000000000000000000000000000000000000000000000000000                                                                                                                                                                                                     
00                                                                                                                                     00                   00                   00                  00
00                                                                                                                                     00                   00                   00                  00
00           p                                                                                                                         00                   00                   00                  00
00                                                                                                                                     00                   00                   00                  00
00           s                                                                                                                         00                   00                   00                  00
00                                                                                                                                     00                   00                   00                  00
00                                                                                                                                     00                   00                   00                  00
0000000000000000000000000000000000000000000000000000000000000000000000000000000000000000000000000000000000000000000000000000000000000000000000000000000000000000000000000000000000000000000000000000000
ZZZZZZZZZZZZZZZZZZZZZZZZZZZZZZZZZZZZZZZZZZZZZZZZZZZZZZZZZZZZZZZZZZZZZZZZZZZZZZ                            ZZZZZZZZZZZZZZZZZZZZZZZZZZZZZZZZZZZZZZZZZZZZZZZZZZZZZZZZZZZZZZZZZZZZZZZZZZZZZZZZZZZZZZZZZZZZZ
ZZZZZZZZZZZZZZZZZZZZZZZZZZZZZZZZZZZZZZZZZZZZZZZZZZZZZZZZZZZZZZZZZZZZZZZZZZZZZZZZ                             ZZZZZZZZZZZZZZZZZZZZZZZZZZZZZZZZZZZZZZZZZZZZZZZZZZZZZZZZZZZZZZZZZZZZZZZZZZZZZZZZZZZZZZZZZZ
ZZZZZZZZZZZZZZZZZZZZZZZZZZZZZZZZZZZZZZZZZZZZZZZZZZZZZZZZZZZZZZZZZZZZZZZZZZZZZ                                 ZZZZZZZZZZZZZZZZZZZZZZZZZZZZZZZZZZZZZZZZZZZZZZZZZZZZZZZZZZZZZZZZZZZZZZZZZZZZZZZZZZZZZZZZZ
ZZZZZZBBBBBBBBBBBBBBBBBBBBBBBBBBBBBBBBBBBBBBBBBBBBBBBBBBBBBBBBBBBBBBBBBBBBBBBBBBBBBBBBBBBBBBBBBBBBBBBBBBBBBBBBBBBBBBBBBBBBBBBBBBBBBBBBBBBBBBBBBBBBBBBBBBBBBBBBBBBBBBBBBBBBBBBBBBBBBBBBBBBBBBBBBZZZZZZZZ
ZZZZZZBBBBBBBBBBBBBBBBBBBBBBBBBBBBBBBBBBBBBBBBBBBBBBBBBBBBBBBBBBBBBBBBBBBBBBBBBBBBBBBBBBBBBBBBBBBBBBBBBBBBBBBBBBBBBBBBBBBBBBBBBBBBBBBBBBBBBBBBBBBBBBBBBBBBBBBBBBBBBBBBBBBBBBBBBBBBBBBBBBBBBBBBBZZZZZZZZ
ZZZZZZBBBBBBBBBBBBBBBBBBBBBBBBBBBBBBBBBBBBBBBBBBBBBBBBBBBBBBBBBBBBBBBBBBBBBBBBBBBBBBBBBBBBBBBBBBBBBBBBBBBBBBBBBBBBBBBBBBBBBBBBBBBBBBBBBBBBBBBBBUBBBBBBBBBBBBBBBBBBBBBBBBBBBBBBBBBBBBBBBBBBBBBBBZZZZZZZZ
ZZZZZZBBBBBBBBBBBBBBBBBBBBBBBBBBBBBBBBBBBBBBBBBBBBBBBBBBBBBBBBBBBBBBBBBBBBBBBBBBBBBBBBBBBBBBBBBBBBBBBBBBBBBBBBBBBBBBBBBBBBBBBBBBBBBBBBBBBBBBBBBBBBBBBBBBBBBBBBBBBBBBBBBBBBBBBBBBBBBBBBBBBBBBBBBZZZZZZZZ
ZZZZZZBBBBBBBBBBBBBBBBBBBBBBBBBBBBBBBBBBBBBBBBBBBBBBBBBBBBBBBBBBBBBBBBBBBBBBBBBBBBBBBBBBBBBBBBBBBBBBBBBBBBBBBBBBBBBBBBBBBBBBBBBBBBBBBBBBBBBBBBBBBBBBBBBBBBBBBBBBBBBBBBBBBBBBBBBBBBBBBBBBBBBBBBBZZZZZZZZ
ZZZZZZBBBBBBBBBBBBBBBBBBBBBBBBBBBBBBBBBBBBBBBBBBBBBBBBBBBBBBBBBBBBBBBBBBBBBBBBBBBBBBBBBBBBBBBBBBBBBBBBBBBBBBBBBBBBBBBBBBBBBBBBBBBBBBBBBBBBBBBBBBBBBBBBBBBBBBBBBBBBBBBBBBBBBBBBBBBBBBBBBBBBBBBBBZZZZZZZZ
ZZZZZZBBBBBBBBBBBBBBBBBBBBBBBBBBBBBBBBBBBBBBBBBBBBBBBBBBBBBBBBBBBBBBBBBBBBBBBBBBBBBBBBBBBBBBBBBBBBBBBBBBBBBBBBBBBBBBBBBBBBBBBBBBBBBBBBBBBBBBBBBBBBBBBBBBBBBBBBBBBBBBBBBBBBBBBBBBBBBBBBBBBBBBBBBZZZZZZZZ
ZZZZZZBBBBBBBBBBBBBBBBBBBBBBBBBBBBBBBBBBBBBBBBBBBBBBBBBBBBBBBBBBBBBBBBBBBBBBBBBBBBBBBBBBBBBBBBBBBBBBBBBBBBBBBBBBBBBBBBBBBBBBBBBBBBBBBBBBBBBBBBBBBBBBBBBBBBBBBBBBBBBBBBBBBBBBBBBBBBBBBBBBBBBBBBBZZZZZZZZ
ZZZZZZBBBBBBBBBBBBBBBBBBBBBBBBBBBBBBBBBBBBBBBBBBBBBBBBBBBBBBBBBBBBBBBBBBBBBBBBBBBBBBBBBBBBBBBBBBBBBBBBBBBBBBBBBBBBBBBBBBBBBBBBBBBBBBBBBBBBBBBBBBBBBBBBBBBBBBBBBBBBBBBBBBBBBBBBBBBBBBBBBBBBBBBBBZZZZZZZZ
ZZZZZZBBBBBZZZZZZZZZZZZZZZZZZZZZZBBBZZZZZZZZZZZZZZZZZZZZZZZZBBBZZZZZZZZZZBBBBBBZZZZZZBBBZZZZZZZZZZZZZZZZZZZZZBBBBBBBBBBBBBBZZZZZZZBBBBBBBBBBBBBZZZZZZZBBBZZZZZZZZZZZZZZZZZZZZZZZBBBBBBBBBBBBBBBZZZZZZZZ
ZZZZZZBBBBBZ00000000000000000000ZBBBZ0000000000000000000000ZBBBZ00000000ZZBBBBBZ0000ZBBBZ0000000000000000000ZZBBBBBBBBBBBBBZ00000ZZBBBBBBBBBBBBZ00000ZBBBZ000000000000000000000ZBBBBBBBBBBBBBBBZZ     N
ZZZZZZBBBBBZ00000000000000000000ZBBBZ0000000000000000000000ZBBBZ000000000ZZBBBBZ0000ZBBBZ00000000000000000000ZZBBBBBBBBBBBBZ000000ZZBBBBBBBBBBZ000000ZBBBZ000000000000000000000ZBBBBBBBBBBBBBB        N 
ZZZZZZBBBBBZ0000ZZZZZZZZZZZZZZZZZBBBZZZZZZZZZ000000ZZZZZZZZZBBBZ0000Z00000ZZBBBZ0000ZBBBZ0000BBBBBBBBBBBBB0000ZBBBBBBBBBBBBZ0000000ZZBBBBBBBBZ0000000ZBBBZ0000ZZZZZZZZZZZZZZZZZZBBBBBBBBBBBBB         N
ZZZZZZBBBBBZ0000ZBBBBBBBBBBBBBBBBBBBBBBBBBBBZZ0000ZZBBBBBBBBBBBZ0000ZZ00000ZZBBZ0000ZBBBZ0000BBBBBBBBBBBBB0000ZBBBBBBBBBBBBZ0000Z000ZBBBBBBBZ000Z0000ZBBBZ0000ZBBBBBBBBBBBBBBBBBBBBBBBBBBBBBBB        N 
ZZZZZZBBBBBZ0000ZZBBBBBBBBBBBBBBBBBBBBBBBBBBBZ0000ZBBBBBBBBBBBBZ0000ZZZ00000ZBBZ0000ZBBBZ0000BBBBBBBBBBBBB0000ZBBBBBBBBBBBBZ0000ZZ000ZBBBBBZ000ZZ0000ZBBBZ0000ZBBBBBBBBBBBBBBBBBBBBBBBBBBBBBBBBZZZZZZZZ
ZZZZZZBBBBBZ0000ZZZZZZZZZZZZZZZZZBBBBBBBBBBBBZ0000ZBBBBBBBBBBBBZ0000ZBZZ0000ZBBZ0000ZBBBZ0000BBBBBBBBBBBBB0000ZBBBBBBBBBBBBZ0000ZZZ000ZZZZZ000ZZZ0000ZBBBZ0000ZZZZZZZZZZZZZZZZZZBBBBBBBBBBBBBBBZZZZZZZZ
ZZZZZZBBBBBZ00000000000000000000ZBBBBBBBBBBBBZ0000ZBBBBBBBBBBBBZ0000ZBBZ0000ZZBZ0000ZBBBZ0000BBBBBBBBBBBBB0000ZBBBBBBBBBBBBZ0000ZBZZ000000000ZZBZ0000ZBBBZ000000000000000000000ZBBBBBBBBBBBBBBBZZZZZZZZ
ZZZZZZBBBBBZ00000000000000000000ZBBBBBBBBBBBBZ0000ZBBBBBBBBBBBBZ0000ZBBZ00000ZBZ0000ZBBBZ0000BBBBBBBBBBBBB0000ZBBBBBBBBBBBBZ0000ZBBZZZ00000ZZZBBZ0000ZBBBZ000000000000000000000ZBBBBBBBBBBBBBBBZZZZZZZZ
ZZZZZZBBBBBZ0000ZZZZZZZZZZZZZZZZZBBBBBBBBBBBBZ0000ZBBBBBBBBBBBBZ0000ZBBZ00000ZZZ0000ZBBBZ0000BBBBBBBBBBBBB0000ZBBBBBBBBBBBBZ0000ZBBBBZZ000ZZBBBBZ0000ZBBBZ0000ZZZZZZZZZZZZZZZZZZBBBBBBBBBBBBBBBZZZZZZZZ
ZZZZZZBBBBBZ0000ZBBBBBBBBBBBBBBBBBBBBBBBBBBBBZ0000ZBBBBBBBBBBBBZ0000ZBBZ000000ZZ0000ZBBBZ0000BBBBBBBBBBBBB0000ZBBBBBBBBBBBBZ0000ZBBBBBZZ0ZZBBBBBZ0000ZBBBZ0000ZBBBBBBBBBBBBBBBBBBBBBBBBBBBBBBBBZZZZZZZZ
ZZZZZZBBBBBZ0000ZBBBBBBBBBBBBBBBBBBBBBBBBBBBZZ0000ZZBBBBBBBBBBBZ0000ZBBZZZ00000Z0000ZBBBZ0000BBBBBBBBBBBBB0000ZBBBBBBBBBBBBZ0000ZBBBBBBZZZBBBBBBZ0000ZBBBZ0000ZBBBBBBBBBBBBBBBBBBBBBBBBBBBBBBBBZZZZZZZZ
ZZZZZZBBBBBZ0000ZBBBBBBBBBBBBBBBBBBBZZZZZZZZZ000000ZZZZZZZZZBBBZ0000ZBBBBZZ000000000ZBBBZ0000BBBBBBBBBBBBB0000ZBBBBBBBBBBBBZ0000ZBBBBBBBBBBBBBBBZ0000ZBBBZ0000ZZZZZZZZZZZZZZZZZZBBBBBBBBBBBBBBBZZZZZZZZ
ZZZZZZBBBBBZ0000ZBBBBBBBBBBBBBBBBBBBZ0000000000000000000000ZBBBZ0000ZBBBBBZZ00000000ZBBBZ00000000000000000000ZZBBBBBBBBBBBBZ0000ZBBBBBBBBBBBBBBBZ0000ZBBBZ000000000000000000000ZBBBBBBBBBBBBBBBZZZZZZZZ
ZZZZZZBBBBBZ0000ZBBBBBBBBBBBBBBBBBBBZ0000000000000000000000ZBBBZ0000ZBBBBBBZZ0000000ZBBBZ0000000000000000000ZZBBBBBBBBBBBBBZ0000ZBBBBBBBBBBBBBBBZ0000ZBBBZ000000000000000000000ZBBBBBBBBBBBBBBBZZZZZZZZ
ZZZZZZBBBBBZZZZZZBBBBBBBBBBBBBBBBBBBZZZZZZZZZZZZZZZZZZZZZZZZBBBZZZZZZBBBBBBBZZZZZZZZZBBBZZZZZZZZZZZZZZZZZZZZZBBBBBBBBBBBBBBZZZZZZBBBBBBBBBBBBBBBZZZZZZBBBZZZZZZZZZZZZZZZZZZZZZZZBBBBBBBBBBBBBBBZZZZZZZZ
ZZZZZZBBBBBBBBBBBBBBBBBBBBBBBBBBBBBBBBBBBBBBBBBBBBBBBBBBBBBBBBBBBBBBBBBBBBBBBBBBBBBBBBBBBBBBBBBBBBBBBBBBBBBBBBBBBBBBBBBBBBBBBBBBBBBBBBBBBBBBBBBBBBBBBBBBBBBBBBBBBBBBBBBBBBBBBBBBBBBBBBBBBBBBBBBZZZZZZZZ
ZZZZZZBBBBBBBBBBBBBBBBBBBBBBBBBBBBBBBBBBBBBBBBBBBBBBBBBBBBBBBBBBBBBBBBBBBBBBBBBBBBBBBBBBBBBBBBBBBBBBBBBBBBBBBBBBBBBBBBBBBBBBBBBBBBBBBBBBBBBBBBBBBBBBBBBBBBBBBBBBBBBBBBBBBBBBBBBBBBBBBBBBBBBBBBBZZZZZZZZ
ZZZZZZBBBBBBBBBBBBBBBBBBBBBBBBBBBBBBBBBBBBBBBBBBBBBBBBBBBBBBBBBBBBBBBBBBBBBBBBBBBBBBBBBBBBBBBBBBBBBBBBBBBBBBBBBBBBBBBBBBBBBBBBBBBBBBBBBBBBBBBBBBBBBBBBBBBBBBBBBBBBBBBBBBBBBBBBBBBBBBBBBBBBBBBBBZZZZZZZZ
ZZZZZZBBBBBBBBBBBBBBBBBBBBBBBBBBBBBBBBBBBBBBBBBBBBBBBBBBBBBBBBBBBBBBBBBBBBBBBBBBBBBBBBBBBBBBBBBBBBBBBBBBBBBBBBBBBBBBBBBBBBBBBBBBBBBBBBBBBBBBBBBBBBBBBBBBBBBBBBBBBBBBBBBBBBBBBBBBBBBBBBBBBBBBBBBZZZZZZZZ
ZZZZZZBBBBBBBBBBBBBBBBBBBBBBBBBBBBBBBBBBBBBBBBBBBBBBBBBBBBBBBBBBBBBBBBBBBBBBBBBBBBBBBBBBBBBBBBBBBBBBBBBBBBBBBBBBBBBBBBBBBBBBBBBBBBBBBBBBBBBBBBBBBBBBBBBBBBBBBBBBBBBBBBBBBBBBBBBBBBBBBBBBBBBBBBBZZZZZZZZ
ZZZZZZBBBBBBBBBBBBBBBBBBBBBBBBBBBBBBBBBBBBBBBBBBBBBBBBBBBBBBBBBBBBBBBBBBBBBBBBBBBBBBBBBBBBBBBBBBBBBBBBBBBBBBBBBBBBBBBBBBBBBBBBBBBBBBBBBBBBBBBBBBBBBBBBBBBBBBBBBBBBBBBBBBBBBBBBBBBBBBBBBBBBBBBBBZZZZZZZZ
ZZZZZZBBBBBBBBBBBBBBBBBBBBBBBBBBBBBBBBBBBBBBBBBBBBBBBBBBBBBBBBBBBBBBBBBBBBBBBBBBBBBBBBBBBBBBBBBBBBBBBBBBBBBBBBBBBBBBBBBBBBBBBBBBBBBBBBBBBBBBBBBBBBBBBBBBBBBBBBBBBBBBBBBBBBBBBBBBBBBBBBBBBBBBBBBZZZZZZZZ
ZZZZZZBBBBBKBBBBBBBBBBBBBBBBBBBBBBBBBBBBBBBBBBBBBBBBBBBBBBBBBBBBBBBBBBBBBBBBBBBBBBBBBBBBBBBBBBBBBBBBBBBBBBBBBBBBBBBBBBBBBBBBBBBBBBBBBBBBBBBBBBBBBBBBBBBBBBBBBBBBBBBBBBBBBBBBBBBBBBBBBBBBBBBBBBBZZZZZZZZ
ZZZZZZBBBBBBBBBBBBBBBBBBBBBBBBBBBBBBBBBBBBBBBBBBBBBBBBBBBBBBBBBBBBBBBBBBBBBBBBBBBBBBBBBBBBBBBBBBBBBBBBBBBBBBBBBBBBBBBBBBBBBBBBBBBBBBBBBBBBBBBBBBBBBBBBBBBBBBBBBBBBBBBBBBBBBBBBBBBBBBBBBBBBBBBBBZZZZZZZZ
ZZZZZZBBBBBBBBBBBBBBBBBBBBBBBBBBBBBBBBBBBBBBBBBBBBBBBBBBBBBBBBBBBBBBBBBBBBBBBBBBBBBBBBBBBBBBBBBBBBBBBBBBBBBBBBBBBBBBBBBBBBBBBBBBBBBBBBBBBBBBBBBBBBBBBBBBBBBBBBBBBBBBBBBBBBBBBBBBBBBBBBBBBBBBBBBZZZZZZZZ
ZZZZZZZZZZZZZZZZZZZZZZZZZZZZZZZZZZZZZZZZZZZZZZZZZZZZZZZZZZZZZZZZZZZZZZZZZZZZZZZZZZZZZZZZZZZZZZZZZZZZZZZZZZZZZZZZZZZZZZZZZZZZZZZZZZZZZZZZZZZZZZZZZZZZZZZZZZZZZZZZZZZZZZZZZZZZZZZZZZZZZZZZZZZZZZZZZZZZZZZ
ZZZZZZZZZZZZZZZZZZZZZZZZZZZZZZZZZZZZZZZZZZZZZZZZZZZZZZZZZZZZZZZZZZZZZZZZZZZZZZZZZZZZZZZZZZZZZZZZZZZZZZZZZZZZZZZZZZZZZZZZZZZZZZZZZZZZZZZZZZZZZZZZZZZZZZZZZZZZZZZZZZZZZZZZZZZZZZZZZZZZZZZZZZZZZZZZZZZZZZZ
ZZZZZZZZZZZZZZZZZZZZZZZZZZZZZZZZZZZZZZZZZZZZZZZZZZZZZZZZZZZZZZZZZZZZZZZZZZZZZZZZZZZZZZZZZZZZZZZZZZZZZZZZZZZZZZZZZZZZZZZZZZZZZZZZZZZZZZZZZZZZZZZZZZZZZZZZZZZZZZZZZZZZZZZZZZZZZZZZZZZZZZZZZZZZZZZZZZZZZZZ